Astral Prison
darkness:0.4,0
start:24,38
lord_of_fallow_fields:18,25
-items
-enditems
-codes
. floor_stone
, floor_magic
; floor_void
g floor_grass
r floor_road
~ water
D water_deep
T tree
? statue
# wall_stone
w wall_marble
+ door_stone
G glass
+ door_stone
* warpstone
% bones
t void_tree
& ancient_prison_door
> downstairs
-endcodes
-connections
south:astral_prison_2
stairs:heart_of_the_void
-endconnections
#...............#....................#..
#...............#....................#..
#...............#....................#..
########################################
#;;;;;;;;;;;;;;;;;;;;;;;;;;;;;;;;;;;;#..
##;;;;;;;;;;;;;;;;;;;;;;;;;;;;;;;;;;;#..
###;;;;;;;;;;;;;;;;;;;;;;;;;;;;;;;;;;#..
####;;;;;;;;;;;;;;;;;;;;;;;;;;;;;;;;;#..
####;;;;;;;;;;;;;;;;;;;;;;;;;;;;;;;;;#..
#####;;;;;;;;;;;;;;;;;;;;;;;;;;;;;;;;#..
######;;;;;;;;;;;;;;;;;;;;;;;;;;;;;;;#..
###########.#####;;;;;;;;;;;;;;;;;;;;#..
#.......#.....#.#;;;;;;;;;;;;;;;;;;;;#..
#.......##...##.#;;;;;;;;;;;;;;;;;;;;#..
#........#...#..#;;;;;;;;;;;;;;;;;;;;#..
#........##.##..#;;;;;;;;;;;;;;;;;;;;#..
#.........#.#...#;;;;;;;;;;;;;;;;;;;;#..
#.........#.#...############;#########..
#.........#.#...#;;;;;;;;;;;;;;;;;;;;#..
#.........#.#.###;;;;;.....;;...;;;;;###
#.........#.#.#;;;;;......;;;;....;;;;;#
#.........#.#.#;;;;.......;;;;;....;;;;#
#.......###&###;;;;......;;;;;;.....;;;#
#.......#.....#;;;......;;;;;;;;....;;;#
#.......#..>..#;;;.......;;;;;;;.....;;#
#.......#.....#;;.........;;;;;.......;#
#.......#######;...........;;;........;#
#.............#;............;.........;#
#.............#;......................;#
#.............#;;...........,........;;#
#.............#;;..........,,,.......;;#
#.............#;;;........,,,,,.....;;;#
#.............#;;;.........,,,......;;;#
#.............#;;;;.........,......;;;;#
#.............#;;;;;;.............;;;;;#
#.............###;;;;;;.........;;;;;###
#...............###############.########
#...................#.....#......#######
#...................#.?..........#######
#...................#.....#......#######
############################.###########