Coruscating Beach
bloated_wretch:6,19
timid_wretch:7,18
timid_wretch:7,20
thin_wretch:5,25
thin_wretch:6,23
thin_wretch:5,25
thin_wretch:7,26
the_wretched_mass:20,7
-items
arcane_radiance:13,20
-enditems
-codes
. floor_sand
; floor_stone
" floor_mossy_stone
# wall_sand
~ water
: water_mossy
? statue
+ locked_door
! door_unlocker
-endcodes
-connections
west:cbeach_1
-endconnections
~~~~~~~~~~~~~~~~~~~~~~~~~~~~~~~~~~~~~~~~
.....~~~~~~~~.........................##
.......~~~~~~~......................####
........~~~~~~~....#####################
..........~~~~..####........~~~~~~:~~..#
...........~~..##............~~~:~~~..##
............~.##..............~::~~..###
............~.#................~~~...###
...#........~.#................~:~.#####
...........~~.##................~...####
...........~...##..............~~....###
.....#....~~....##........#...::~....###
..........~......#........##...~~:....##
...##.....~......###............~~~...##
...#......~~~......#####.......~:~~~..##
...#.......~~:.........##.......~:~~~.##
............~~..........##......~..~~~.#
.....#.....~~~~.....#....##.....~..#:###
.....#....~~~~~~..........#####~~###...#
..####..~~~~~~~~~~....#.......#~##....?#
.......~~:;;;~~~:~~..........####.....##
.......~~~~;";~~~~~........######....###
.......~~~~;";~~~~~........+!.#####.####
....#...~~"";";~~~........##...#......##
.........~~~:~~~~........##............#
..........~~~~~~........##.........#####
####.......~~~~~........#....#....######
#..#####....~~~~...#....#....#.......###
#......###...~~~........#....###......##
#........##...~~........#......##......#
#.........#....~.....#..#.......#......#
#.........#....~~.......#...############
#.........##....~~.....##.........######
#..........##....~~....#............####
#...........#####~::~~##.............###
................##:~:##...............##
.................#####................##
......................................##
#....................................###
#..................................#####
########################################