Coruscating Beach
start:2,2
thin_wretch:13,6
thin_wretch:15,5
thin_wretch:16,4
timid_wretch:27,12
bloated_wretch:28,14
bloated_wretch:24,33
timid_wretch:23,32
timid_wretch:22,32
thin_wretch:38,31
thin_wretch:39,32
thin_wretch:37,32
thin_wretch:39,34
thin_wretch:40,33
-items
driftwood_wand:23,6
battered_wooden_shield:21,15
-enditems
-codes
. floor_sand
; floor_stone
" floor_mossy_stone
# wall_sand
~ water
: water_mossy
? statue
T terminal
-endcodes
-connections
west:stardrift_wreckage_1
east:cbeach_2
-endconnections
~~~~~~~~~~~~~~~~~~~~~~~~~~~~~~~~~~~~~~~~
~~~~~~~.................................
..~~~~~~................................
...~~~~~~......######...................
....~~~~.....###....#####...............
.....~~~....##......;";;#...............
......~~...........:.;;"#...............
.......~....##....~~#####...............
.............########....#..####........
..................~~~~~.#..~~~..........
................#~~~~~~~~...~~..........
...............~~~~..#.~~~.#.:~#........
.......#######..~~#.~~~.:~..~~..........
......##.....##.~~.~~.#~~:~..#..#.......
.....##.......##.#~~:~..~~..............
.....#........###.~~~~...~#.:~..........
...###.;........##..#::~~..~~~...#......
.........;...."..#~:~..#~~~...:..#......
...###;;;.;;;..;;#..~~~~.~~.#....#......
.....#;";;;;;;";;#........~::~~.........
.....#;;;;";;;;;##....####...:###.......
.....##;;;;?;";T#........###............
......#;";;;;;;;#.......................
......##;";";;###.......................
.......#"";;###........#................
.......######..........####.............
...................#......#............#
...................#......######......##
...................##......###~#.....###
....................#....#...#~#########
....................##...##..#:~.......#
.....................#....#............#
.....................#....####.........#
#....................#.....~~#.........#
#..................###....~~~#####...###
#..............#####.....~~:~~~~~#...#..
#..............#~~~.....~~########......
#..............#~~~~...~~~~..........###
##........######~~:~~~~~~~~~...........#
########################################