Chapel of Flame
start:19,0
molten_knight:15,23
molten_knight:20,23
azarel:18,25
-items
-enditems
-codes
. floor_grass
, floor_singed
; floor_stone
r floor_road
# wall_stone
% bush
T tree
+ door_stone
D water_deep
~ water
& flame_door
w wall_wood
? statue
-endcodes
-connections
north:pilgrims_road_3
south:ashen_rotunda_1
-endconnections
##################.r.###################
#.............%....r...%.............%.#
#..%..T............r.......T......%....#
#..............T.%..r.....%....T.......#
#.T.........%......................T%..#
#...%....wwwwwwwwww&wwwwwwwwwww........#
#.....T.%w;;;;;;w;;;;;w;;;;;;;w..%.....#
#........w;,;;;;w;;;;;w;;,;;;;w..T.....#
#..%T....w;;;;;;w;?;;;+;;;,,;;w........#
#........w;;;,;;w;;;;;w;;;,;;;w......T.#
##....wwww;;;,,;wwwwwww;;,;;;;wwww...%.#
##....w;;;;;;;;;;,,;;;;;,,;;;,,;;w.....#
##....w;;;,,;;;;;,;;;;;;;;,,;;;;;w.....#
###...w;;;;;;;;;;;;;,,,;;,,,;;;;;w.%...#
####..w;;;;;;;;;;;;;;;;;;;;;;;,;;w.....#
#####.w;;;;,;;;;;;;;;,;;;;;;,;;;;w..T..#
#####.w;;,,,;;;,;;;;;;;;;;;,,;;;;w.....#
######w;;;;;;;,;,;;;;;;;;;;;;;;;;w...%.#
######w;;;;;;,,,;;;;;;;;;;;;;;;;;w...T.#
#####.w;;;;;;;;;,,;;;;;;;;;;;;;;;w.....#
####..w;;;;;;;;,,,;;;;;;;;;;;;;;;w.....#
###...w;;;;;;;;;;;;;;,;;;;;;;;;;;w.T.%.#
###...w;;;;;,,,;;;;;,,;;;;;;;;;;;w.....#
##wwwww;;;;;;;;;;;;;;;;;;;;;;;;;;wwwww.#
#.w;;;;;;;;;;,,;;;;;;;;;;;;;;;;;;;;;;w.#
#.w;;;,;;w;;;;,;;;;;;;;;;;;;;;w;;;;;;w.#
#.w;;,,;www;;,,;;;,;;;;;;;;,,www;;;;;w.#
#.w;;;;wwwww;;;;;,,;;;;;;;;;wwwww;;;;w.#
#.w;;;;;www;;;;;;;;;;;;;;;;;;www;;;;;w##
#.w;;;;;;w;;;;;;,,,;;;;,;;;;;;w;;,;;;w##
#.w;;,;;;;;;;;;;;;;;;;;;;;;;;;;;,,;;;w##
#.w;,,;;;,,;;;;;;;;;;;,,;;;,,;;;;;;;;w##
#.w;;;;;,,,;;;;;;;;;;;;;;;,,,;;;;;;;;w##
#.w;;;;;;;;;;;,,;;;,;;;;;;;;,,;;;;;;;w##
#.wwwwwwww;;;,,;;;;,,,;;;;;;;;wwwwwwww.#
#........w;;;;;;;;;;,,,,;;;;;;w........#
#%..%..T.w;;;;,,,;;;;;;;;;;;;;w......T.#
#........w;;,,;;;;;;;;;;;;;;;;w..T.....#
#.T....%.wwwwwwwwww+wwwwwwwwwww........#
#..%.T...................%..........T..#
##..........%.......................####