Moon Gate
start:39,20
-items
noble_glowing_gemstone:12,18
-enditems
-codes
M moon_gate
. floor_magic
; floor_void
" floor_mossy_stone
# wall_stone
= wall_magic
~ water
: water_mossy
? statue
* warpstone
D water_deep
G glass
+ door_stone
o ooze
> downstairs
-endcodes
-connections
east:bridge_of_lords_1
-endconnections
;;;;;;;;;;;;;;;;;;;;;;;;;;;;;;;;;;;;;;;;
;;;;;;;;;;;;;;;;;;;;;;;;;;;;;;;;;;;;;;;;
;;;;;;;;;;;;;;;;;;;;;;;;;;;;;;;;;;;;;;;;
;;;;;;;;;;;;;;;;;;;;;;;;;;;;;;;;;;;;;;;;
;;;;;;;;;;;;;;;;;;;;;;;;;;;;;;;;;;;;;;;;
;;;;;;;;;;;;;;;;;;;;;;;;;;;;;;;;;;;;;;;;
;;;;;;;;;;;;;;;;;;;;;;;;;;;;;;;;;;;;;;;;
;;;;;;;;;;;;;;;;;;;;;;;;;;;;;;;;;;;;;;;;
;;;;;;;;;;;;;;;;;;;;;;;;;;;;;;;;;;;;;;;;
;;;;;;;;;;;;;;;;;;;;;;;;;;;;;;;;;;;;;;;;
;;;;;;;;;;;;;;;;;;;;;;;;;;;;;;;;;;;;;;;;
;;;;;;;;;;;;;;;;;;;;;;;;;;;;;;;;;;;;;;;;
;;#############;;;;;;;;;;;;;;;;;;;;;;;;;
;MM............##;;;;;;;;;;;;;;;;;;;;;;;
;MM.............###;;;;;;;;;;;;;;;;;;;;;
;;MM..............######################
;;;MM...................................
;;;MM...................................
;;;;MM..................................
;;;;;MM.................................
;;;;;MM.................................
;;;;;;MM..........*.....................
;;;;;MM.................................
;;;;;MM.................................
;;;;MM..................................
;;;MM...................................
;;;MM...................................
;;MM..............######################
;MM.............###;;;;;;;;;;;;;;;;;;;;;
;MM...........###;;;;;;;;;;;;;;;;;;;;;;;
;;#############;;;;;;;;;;;;;;;;;;;;;;;;;
;;;;;;;;;;;;;;;;;;;;;;;;;;;;;;;;;;;;;;;;
;;;;;;;;;;;;;;;;;;;;;;;;;;;;;;;;;;;;;;;;
;;;;;;;;;;;;;;;;;;;;;;;;;;;;;;;;;;;;;;;;
;;;;;;;;;;;;;;;;;;;;;;;;;;;;;;;;;;;;;;;;
;;;;;;;;;;;;;;;;;;;;;;;;;;;;;;;;;;;;;;;;
;;;;;;;;;;;;;;;;;;;;;;;;;;;;;;;;;;;;;;;;
;;;;;;;;;;;;;;;;;;;;;;;;;;;;;;;;;;;;;;;;
;;;;;;;;;;;;;;;;;;;;;;;;;;;;;;;;;;;;;;;;
;;;;;;;;;;;;;;;;;;;;;;;;;;;;;;;;;;;;;;;;
;;;;;;;;;;;;;;;;;;;;;;;;;;;;;;;;;;;;;;;;