Void
start:20,39
-items
-enditems
-codes
. floor_stone
; floor_void
g floor_grass
r floor_road
~ water
D water_deep
T tree
? statue
# wall_stone
w wall_marble
G glass
+ door_stone
* warpstone
% bones
t void_tree
> downstairs
& slumbering_gate
-endcodes
-connections
west:slumbering_wild
stairs:astral_prison
-endconnections
;;;;;;;;;;;;;;;;;;;;;;;;;;;;;;;;;;;;;;;;
;;;;;;;;;;;;;;;;;;;;;;;;;;;;;;;;;;;;;;;;
;;;;;;;;;;;;;;;;;;;;;;;;;;;;;;;;;;;;;;;;
;;;;;;;;;;;;;;;;;;;;;;;;;;;;;;;;;;;;;;;;
;;;;;;;;;;;;;;;;;;;;;;;;;;;;;;;;;;;;;;;;
;;;;;;;;;;;;;;;;;;;;;;;;;;;;;;;;;;;;;;;;
;;;;;;;;;;;;;;;;;;;;;;;################;
;;;;;;;;;;;;;;;;;;;;;;;#..............#;
;;;;;;;;;;####;;;;;;;;;#..............#;
;;;;;;;;;;..t##;;;;;;;;#..............#;
;;;;;;;;;t....##;;;;;;;#..............#;
;;;;;;;;.......##;;;;;;#..............#;
;;;;;;;t........##;;;;;#..............#;
;;;;;;...........#########...........##;
.................#..................###;
.................&..........>..########;
.................#..................###;
;;;;;;...........#########...........##;
;;;;;;;t........##;;;;;#..............#;
;;;;;;;;.......##;;;;;;#..............#;
;;;;;;;;;t....##;;;;;;;#..............#;
;;;;;;;;;;..t##;;;;;;;;#..............#;
;;;;;;;;;;####;;;;;;;;;#..............#;
;;;;;;;;;;;;;;;;;;;;;;;#..............#;
;;;;;;;;;;;;;;;;;;;;;;;################;
;;;;;;;;;;;;;;;;;;;;;;;;;;;;;;;;;;;;;;;;
;;;;;;;;;;;;;;;;;;;;;;;;;;;;;;;;;;;;;;;;
;;;;;;;;;;;;;;;;;;;;;;;;;;;;;;;;;;;;;;;;
;;;;;;;;;;;;;;;;;;;;;;;;;;;;;;;;;;;;;;;;
;;;;;;;;;;;;;;;;;;;;;;;;;;;;;;;;;;;;;;;;
;;;;;;;;;;;;;;;;;;;;;;;;;;;;;;;;;;;;;;;;
;;;;;;;;;;;;;;;;;;;;;;;;;;;;;;;;;;;;;;;;
;;;;;;;;;;;;;;;;;;;;;;;;;;;;;;;;;;;;;;;;
;;;;;;;;;;;;;;;;;;;;;;;;;;;;;;;;;;;;;;;;
;;;;;;;;;;;;;;;;;;;;;;;;;;;;;;;;;;;;;;;;
;;;;;;;;;;;;;;;;;;;;;;;;;;;;;;;;;;;;;;;;
;;;;;;;;;;;;;;;;;;;;;;;;;;;;;;;;;;;;;;;;
;;;;;;;;;;;;;;;;;;;;;;;;;;;;;;;;;;;;;;;;
;;;;;;;;;;;;;;;;;;;;;;;;;;;;;;;;;;;;;;;;
;;;;;;;;;;;;;;;;;;;;;;;;;;;;;;;;;;;;;;;;
;;;;;;;;;;;;;;;;;;;;;;;;;;;;;;;;;;;;;;;;