Void Mausoleum
voidwalker_penelope:10,20
-items
sir_percivels_ring:22,20
-enditems
-codes
. floor_magic
; floor_void
" floor_mossy_stone
# wall_stone
= wall_magic
~ water
: water_mossy
? statue
D water_deep
G glass
+ door_stone
o ooze
> downstairs
t void_tree
-endcodes
-connections
west:void_mausoleum_2
south:void_mausoleum_4
-endconnections
;;;;;;;;;;;;;;;;;;;;;;;;;;;;;;;;;;;;;;;;
;;;;;;;;;;;;;;;;;;;;;;;;;;;;;;;;;;;;;;;;
;;;;;;;;;;;;;;;;;;;;;;;;;;;;;;;;;;;;;;;;
;;;;;;;;;;;;;;;;;;;;;;;;;;;;;;;;;;;;;;;;
;;;;;;;;;;;;;;;;;;;;;;;;;;;;;;;;;;;;;;;;
;;;;;;;;;;;;;;;;;;;;;;;;;;;;;;;;;;;;;;;;
;;;;;;;;;;;;;;;;;;;;;;;;;;;;;;;;;;;;;;;;
;;;;;;;;;;;;;;;;;;;;;;;;;;;;;;;;;;;;;;;;
;;;;;;;;;;;;;;;;;;;;;;;;;;;;;;;;;;;;;;;;
;;;;;;;;;;;;;;;;;;;;;;;;;;;;;;;;;;;;;;;;
;;;;;;;;;;;;;;;;;;;;;;;;;;;;;;;;;;;;;;;;
;;;;;;;;;;;;;;;;;;;;;;;;;;;;;;;;;;;;;;;;
;;;;;;;;;;;;;;;;;;;;;;;;;;;;;;;;;;;;;;;;
;;;;;;;;;;;;;;;;;;;;;;;;;;;;;;;;;;;;;;;;
;;;;;;................;;;;;;;;;;;;;;;;;;
;;;;;..=============...;;;;;;;;;;;;;;;;;
;;;;...=...........=....;;;;;;;;;;;;;;;;
;;;....=...........+.....;;;;;;;;;;;;;;;
;;;....=...........=......;;;;;;;;;;;;;;
;;...===...........=....?..;;;;;;;;;;;;;
.....=.............=......;;;;;;;;;;;;;;
...................=.....;;;;;;;;;;;;;;;
.....=.............=....;;;;;;;;;;;;;;;;
.....===...........=...;;;;;;;;;;;;;;;;;
.......=........====..;;;;;;;;;;;;;;;;;;
.......=........=....;;;;;;;;;;;;;;;;;;;
.......=........=...;;;;;;;;;;;;;;;;;;;;
;;;;;..==========..;;;;;;;;;;;;;;;;;;;;;
;;;;;.........t...;;;;;;;;;;;;;;;;;;;;;;
;;;;;;..t........;;;;;;;;;;;;;;;;;;;;;;;
;;;;;;;.......t.;;;;;;;;;;;;;;;;;;;;;;;;
;;;;;;;....t...;;;;;;;;;;;;;;;;;;;;;;;;;
;;;;;;;.......;;;;;;;;;;;;;;;;;;;;;;;;;;
;;;;;;;.......;;;;;;;;;;;;;;;;;;;;;;;;;;
;;;;;;;;.....;;;;;;;;;;;;;;;;;;;;;;;;;;;
;;;;;;;;;...;;;;;;;;;;;;;;;;;;;;;;;;;;;;
;;;;;;;;;...;;;;;;;;;;;;;;;;;;;;;;;;;;;;
;;;;;;;;;...;;;;;;;;;;;;;;;;;;;;;;;;;;;;
;;;;;;;;;...;;;;;;;;;;;;;;;;;;;;;;;;;;;;
;;;;;;;;;...;;;;;;;;;;;;;;;;;;;;;;;;;;;;
;;;;;;;;;...;;;;;;;;;;;;;;;;;;;;;;;;;;;;